111111111111111111111111111111
1P0000C000000C00000000C00000E1
101110111110111110111110111101
1C000000000C000000C000000000C1
111011101011101110101110111111
1C0000C000000C00000C0000C00001
101111111010111110101011111101
1C000000000000C0000000000000C1
111110111111101111111011111111
1C0000C00000000000C0000000C001
101110111011111110111011101101
1C000000000C000000C00000000001
111011111011111111101111111011
1C000C0000000000000000000C0001
101110111111101110111111101111
111111111111111111111111111111
