111111111111111111111111111111
1P0000C000000C000000C0000000E1
101111011111101111110111110101
1C0000C000000000000000C00000C1
111011111010111110101111101111
1C000000C0000C0000C00000000001
101110111111101110111111101101
1C000000000C00000C0000000000C1
111110111011101110111011101111
1C0000C000000C00000C0000C00001
101111111110111110111111111101
1C00000000000C00000C0000000001
111011101111111111111110111011
1C000C0000000000000000000C0001
101110111011101110111011111011
111111111111111111111111111111
