111111111111111111111111111111
1P0000000C000000C000000X0000E1
101111111011111011111011111101
1C0000000C000000C00000000000C1
111111101011111110101111111111
1C000000C00000X0000C0000000001
101110111111101111111011111101
1C000C000000C00000C00000C00001
11111011101011111X101011101111
1CX00000000000C0000000000000C1
101111011111101111111011110101
1C0000C0000000X0000000C0000001
111011101011111110111010111111
1C00000000000C00000C00000000C1
10111011111110X110111111101111
111111111111111111111111111111
