111111111111111111111111111111
1000E000011100000X000001100001
101110111011111111101110111101
100000000000000000000000000001
101111101110111011111111101111
1000000000000000000000000C0001
111101111111110111110111111111
100000000000000000000000000001
101111111110111111111011111011
100000000000000000000000000001
101110111111101110111111101111
100000000000000000000000000001
111011111011111111101111111011
100000000000000000000000000001
101110111111111111111011111P11
111111111111111111111111111111