1111111
1X1P001
111C001
1111111
100E001
1111111