11111
10P01
11111
10C01
10E01
11111