1111111111111111111111111111111
1P000C000111000000C000011000E01
1011101110111111111011101111001
1C00000000000C00000000000000001
1011111011101110111111111011101
1C00000C00000000000C00000C00001
1111011111111101111101111111101
1C000000000C0000000000000000001
1011111111101111111110111110101
1C00000C00000000000000000000C01
1011101111111011101111111011101
1C00000000000C000000C0000000001
1110111110111111111011111110101
1C000C0000000000000000000C00001
1011101111111111111110111110101
1000000000000000000000000000001
1111111111111111111111111111111