111111111111111111111111111111
1P000C000111000000C000011000E1
101110111011111111101110111101
1C00000000000C0000000000000001
101111101110111011111111101111
1C00000C00000000000C00000C0001
011101111111110111110111111111
1C000000000C000000000000000001
101111111110111111111011111011
1C00000C00000000000000000000C1
101110111111101110111111101111
1C00000000000C000000C000000001
111011111011111111101111111011
1C000C0000000000000000000C0001
101110111111111111111011111010
111111111111111111111111111111